111111111
1000C0001
100000E01
1000P0001
111111111