111111111
1000C0001
10000E001
1P0000001
111111111