1111111111111111111111111111111
1P00000000000000000000000000001
1000000011111000000111110000001
1000000111111000C01111111000001
100000110C01100001100C111000001
1000011000011000000000110C00001
1000111110111000000001100000101
1001111110111000000011C00000101
1000000C00111000001111111000101
1000000000111000011111111000101
10000000000000000000000000001E1
1111111111111111111111111111111