111111111
100C00001
1110P0E01
1000P0001
111111110